[[
  [2013-04-09] added document

  Type: email
  Date: 2 November 2011
  Title: [Tlhingan-hol] Eurotalk - New Words - Shopping
  Author: Michael Roney, Jr.
  Summary: Posting of a transcript of shopping related words from the Eurotalk
    Klingon language course.

]]

Date: Wed, 2 Nov 2011 15:21:18 -0400
From: "Michael Roney, Jr. PKT" <nahqun@gmail.com>
To: tlhIngan Hol mailing list <tlhingan-hol@stodi.digitalkingdom.org>
Subject: [Tlhingan-hol] Eurotalk - New Words - Shopping

If I'm keeping track correctly, tomorrow will be our last day.
"Time", "Numbers", and "Body" don't include any new vocabulary.
(But I can list them if someone feels the need...)


-=-
postcard - QIn 'echletHom
sunglasses - mIn QanwI' nguv
stamp - HIjmeH chaw'
shirt - yIvbeH
tie - mong Ha'quj
pants - yopwaH
jacket - wep
skirt - paH bID
dress - paH
pen - ghItlhwI'
soap - Say'moHwI' tlhagh
shoes - waqmey
T-Shirt - yIvbeH SeQHa'
shorts - yopwaH bID
pencil - ghojmoH ghItlhwI' [[moH:=meH]]
scissors - cha''etlh pe'wI'
envelope - nav qatwI'
socks - paSlogh
hat - mIv
belt - qogh
razor - rol taj
lipstick - wuS rItlh naQ
newspaper - De' chu' ghItlh
umbrella - SIS yoD
book - paq
matches - qul naQmey
light bulb - wovmoHwI' moQ
toothpaste - Ho'Du' Say'moHwI' tlhagh
toothbrush - Ho' teywI'
comb - jIb Ho'Du'
hairbrush - jIb yachwI'
towel - QaDmoHwI' DIr
compact disc - De' jengva'
clock - tlhaq
flashlight - 'ul Sech
teddy bear - mIl'oD ngeb
cassette - wab qoSta' 'aplo'
ball - QujmeH moQ
camera - mIllogh qonwI'
radio - wab HevwI'
television - HaSta jIH
chair - quS
teapot - runpI'
saucepan - Se'tu'
iron - Sut HabmoHwI'
suntan lotion - DIr qanwI' taS [[qanwI':=QanwI']]
film - mIllogh qonwI' qoSta'
paper - nav
batteries - 'ul 'aplo'mey
-=-

I'd just like to point out that I used {rItlh naQ} several years ago
to refer to lipstick, my Klingon teddy bear's name is {mIl'oD}, and if
anyone had told me that at the end of 2011, we'd get the Klingon word
for "cassette tape", I'd've laughed.


~'anan naHQun
-- 
~Michael Roney, Jr.
Professional Klingon Translator
webOS Developer

http://www.twitter.com/roneyii
http://www.google.com/s2/profiles/110546798564536163288

_______________________________________________
Tlhingan-hol mailing list
Tlhingan-hol@stodi.digitalkingdom.org
http://stodi.digitalkingdom.org/mailman/listinfo/tlhingan-hol

[[eof]]
